13 0 0 0 0 0 0 0 0 0 0 0 0 0 0 0 0 0 0 0 0 0 0 0 0 0 0 0 0 0 0 0 0 0 0 0 0 0 0 0 0 0 0 0 14
13 0 0 0 0 0 1 0 0 0 0 0 0 0 0 0 0 0 0 0 0 0 0 0 0 0 0 0 0 0 0 0 0 0 0 0 0 0 0 0 0 0 0 0 14
13 0 0 0 0 0 15 0 0 0 0 0 0 0 0 0 0 1 0 0 0 0 0 0 0 0 0 0 0 0 0 1 0 0 15 0 0 0 0 0 0 5 0 16 14
13 0 0 0 0 0 0 0 0 0 0 0 15 0 0 0 0 15 0 0 0 0 0 0 0 0 0 0 0 0 0 15 0 0 0 0 0 0 0 1 12 12 12 12 14
13 0 0 0 0 0 0 0 9 0 0 0 0 0 0 0 0 0 0 0 0 0 0 0 0 15 0 0 0 0 0 0 0 0 0 0 0 0 0 15 0 0 0 0 14
13 0 0 0 0 0 0 0 15 15 15 0 0 0 15 0 0 0 0 0 0 0 0 0 0 0 0 1 0 0 0 0 15 0 0 0 0 0 0 0 0 0 0 0 14
13 0 0 2 0 0 0 0 0 0 0 0 0 0 0 0 0 0 15 0 15 0 15 0 0 0 0 0 0 0 0 0 0 0 0 2 0 0 15 0 0 15 0 0 14
13 0 0 15 0 15 0 0 0 0 0 0 15 0 0 0 0 0 0 0 0 0 0 0 0 0 12 0 0 12 0 0 0 15 15 15 0 0 0 0 0 0 0 0 14
13 0 0 0 0 0 0 0 1 0 2 0 9 0 0 0 0 0 0 0 0 0 0 2 0 12 12 0 0 12 12 0 0 0 0 0 0 0 0 0 0 2 0 0 14
12 12 12 12 12 12 12 12 12 12 12 12 12 12 12 12 18 18 18 18 18 18 18 12 12 12 12 18 18 12 12 12 12 12 12 12 12 12 12 12 12 12 12 12 12