21 0 0 0 0 0 0 0 0 0 0 0 0 0 0 0 0 0 0 0 0 0 0 0 0 0 0 0 0 0 0 0 0 0 0 0 0 0 0 0 0 0 0 0 22
21 0 0 0 0 0 0 0 0 0 0 0 0 0 0 0 0 0 0 4 0 0 0 0 0 0 0 0 0 0 0 0 0 0 1 0 0 0 0 0 0 0 0 0 22
21 0 0 0 0 0 0 0 0 0 0 0 1 0 0 0 0 0 0 23 0 0 0 0 0 0 0 0 0 0 0 1 0 0 23 0 0 0 0 0 0 0 0 0 22
21 0 0 0 0 0 0 0 0 0 0 0 23 0 0 0 0 1 0 0 0 0 9 0 2 0 1 0 0 0 0 0 0 0 0 0 0 9 0 1 0 0 0 0 22
21 0 0 0 0 0 0 0 9 0 1 0 0 0 4 0 0 23 0 0 0 0 23 0 23 0 23 0 0 0 0 0 2 0 0 0 0 0 0 23 0 0 0 0 22
21 0 0 0 0 0 0 0 23 0 23 0 0 0 23 0 0 0 1 0 2 0 0 0 0 0 0 0 0 0 0 0 23 23 0 0 0 0 0 0 0 0 0 0 22
21 0 0 0 0 0 1 0 0 0 0 0 1 0 0 0 0 0 23 23 23 23 0 1 0 0 0 0 0 23 0 0 0 4 0 0 0 23 0 0 0 23 0 0 22
21 0 0 0 0 0 23 0 0 0 0 0 0 0 0 0 0 0 0 0 0 0 0 23 0 0 0 0 0 0 0 0 0 23 23 23 0 0 0 0 0 0 0 0 22
21 0 0 0 1 0 0 0 1 0 0 4 0 0 0 2 0 0 0 0 0 0 0 0 0 0 0 9 0 0 0 0 0 0 0 0 0 0 0 1 0 0 10 0 22
20 20 20 20 20 18 18 18 20 20 20 20 20 20 20 20 20 18 18 18 18 18 18 18 18 20 20 20 20 20 20 20 20 20 20 20 18 18 20 20 20 20 20 20 20